37
4	13	0	1
4	14	0	1
5	6	0	1
5	10	0	1
6	3	0	1
6	8	0	1
6	14	0	1
6	18	0	1
7	5	0	1
7	7	0	1
7	11	0	1
7	15	0	1
8	13	0	1
8	19	0	1
9	4	0	1
9	9	0	1
10	5	0	1
10	11	0	1
11	9	0	1
12	6	0	1
12	13	0	1
12	17	1	1
13	15	1	1
14	8	1	1
14	12	1	1
15	6	1	1
15	12	1	1
15	18	1	1
16	7	1	1
16	11	1	1
16	13	1	1
16	15	1	1
16	18	1	1
17	5	1	1
17	9	1	1
17	12	1	1
17	15	1	1
